+-+-+-+-+-+-+-+-+-+-+
| |   | | | | | | | |
+ +-+ + + + + + + + +
| |   | | | |   |   |
+ +-+ + + + +-+ + +-+
|           |       |
+ + + +-+-+-+-+ +-+-+
| | | | |           |
+-+-+ + + +-+ +-+-+ +
| | |   | |   | |   |
+ + +-+ + +-+ + +-+ +
| |   |     | | |   |
+ + + +-+ + +-+ + + +
| | |   | |   |   | |
+ + + + +-+-+ +-+ + +
| | | | |   |   | | |
+ + +-+ + + + +-+ + +
|     |   |   |   | |
+ +-+ +-+ +-+-+-+-+-+
|   | | |   |       |
+ + +-+ + +-+-+ + +-+
| | | | | | | | |   |
+ +-+ + + + + +-+-+ +
|     |   |     | | |
+-+-+ +-+ + +-+-+ + +
| |     | |   | | | |
+ + +-+ +-+-+ + + + +
| |   |         |   |
+ + + + + +-+-+ +-+ +
| | | | | |       | |
+ +-+ +-+-+-+ +-+-+ +
| | |     | |     | |
+ + +-+-+ + +-+ + + +
| |         | | |   |
+ +-+ +-+ +-+ + +-+-+
| | |   | |   | | | |
+ + +-+ +-+-+ + + + +
|     |   |   | | | |
+-+-+ + +-+-+ + + + +
|             |     |
+-+-+-+-+-+-+-+-+-+-+
